, , , , . . . , . . , , . , . . . , , ~ ~ ~ ^ ^ A ^ A A ^ ^ A A M M A A A M A A
, , , , , , , . . , . . . , . . . , , ~ ~ ^ ~ ~ ^ ^ ^ A ^ ^ A M A M M A M M M A
~ . . , . . , . . . , . . , . . , , , ~ ~ ^ ~ ~ ~ ~ ^ ^ ^ ^ A M A M A A M A A A
, , , , , , , , . . . . , , , . , , , ~ ~ ~ ^ ^ ~ ~ ^ ^ ^ ^ A A A M M A M A A ^
, . . . . . , . . . . . . . , , , . , ~ ~ ~ ^ ^ ^ ^ ^ ^ ^ ^ A A M A A A A A A A
, , , . . . . . . . . , . , . . , , , , ~ ~ ~ ^ ^ ^ ^ ^ ^ A A A M A A A A A A A
, . . . . . . , . , , . , , , , . , , , ~ ~ ~ ~ ^ ^ ^ ^ ^ A A A M A A A A A A A
. . . . . . . . . , , , . . , . , , , , ~ ~ ~ ~ ^ ^ ^ ^ ^ A A M A A A A A A A A
. . . , . . , , . . . , , . , , , , , , ~ ~ ~ ~ ^ ^ ^ ^ A A M A A M M A M A A M
, , , . . . . . . . , , . , . , , ~ , ~ ~ ~ ~ ~ ~ ~ ~ ^ A A A A M M A A M A A M
. , , , , . . . . . . . . , . , , , , , , ~ ~ ~ ~ ~ ~ ^ A A M M A A A M A A M M
. . , , . . . . . . , , , . . , , , , ~ ~ ~ ~ ~ ~ ~ ~ ^ A A A A A A A A M M M M
. . . . , . . . , . . , . , , , , , , , ~ ~ ~ ~ ~ ~ ~ A A M M M M M M M M M M A
. . . . . , . . . . , , , , . , , , ~ , , ~ ~ ~ ~ ~ ^ A A M M M M A A A A A A A
, . . . . . . . . . . , , . , , , , , , , ~ ~ ~ , ~ ^ A M M M A A M A M A M M M
, . . . , . . . . , , , , . , , , , ~ ~ ~ ~ ~ ~ , ~ ^ A M M A M M M A A A M M M
. , . . . , . . . . , , , , , , , , , ~ ~ ^ ~ , , ~ A A A A M M M A M A M A M A
. . , , , . . , . , ~ , , , , , , , , ~ ^ ~ , , , ~ A A A A A M A A A A A A A A
. , , . . . . . . , , , , , , , , , ~ ^ ~ , , , ~ ~ A M M M M M M A A A A A M M
. , ~ . . . . . . . , , , , , , , , ~ ^ ~ ~ ^ ^ ^ ^ A A A A A M M A M M M M M M
. , , . . , , , , . , , , , , . , ~ @ ^ ^ ^ ~ ^ ^ A M M M M M M M M M M M M M M
, , . . . , ~ , , , , , , , , , ~ ^ ~ ~ , ~ ^ ^ ^ A A A A M M M M M M M M M M M
. , , , , . ~ ~ , , , , , , , , , ~ , , ~ ^ ~ ~ ^ A M M M M A M A A M M M A M M
, , . . . . , , , , , , , , , , , , , ^ ~ ^ ^ ~ ^ A M M M A M M A A A A M A M M
. , , . . , . . , . , , , , , , , ~ ~ ~ ~ ~ ^ ^ A A A M M M M M A M M M A A M A
, , . . . , . , , , , , , , , , ~ ~ , , , ~ ~ ^ A A A A A A A A A A A M A M A M
. . . . . , , , , , . , , , , , ~ , ~ , , ~ ^ ^ A A A M A A A M M A A A A A M A
, , , , . . . , . , , . , ~ , , , , , ~ ~ ~ ^ ^ A A A A A A A A A A A A A M A A
. , . . . . . . . , , ~ , , , , , , ~ ~ ~ ~ ^ ^ A A M A M A A A A A A A A A M A
. . , . , . , , , , , , , , . . , , ~ ~ ^ ^ ^ ^ A A A A A M A A A M A A A A A A
, . . . , , . . , , , , , , , , , , ~ ~ ^ ~ ^ ^ A A A A A A A M M M A A A M A A
. , , , , , . , . , , . , . , , , ~ ~ ^ ^ ~ ~ ^ A A A A A M A M A M A A M A M M
. . , . . , . , , , , , , , . , , ~ ~ ^ ~ ~ ^ ^ A A M M M A A A A M M M A A A A
. . , , , . , , , , . . . . , , , ~ ~ ^ ~ ^ ^ ^ A A A M A A A A A A A M M M A A
. . , , , , , . , , , , , . . , , ~ ~ ~ ~ ^ ^ ^ A A A M M M M M M M M M M A A A
, , , , , , , . , . , , , , . , , ~ ~ ~ ~ ^ ^ ^ A A M A A M M A A A A M M A A A
, , , . , . , . . , , , , . , , , , ~ ~ ^ ^ ^ A A A A A M A A A M M A M A M M A
, . , , . . , , . , , . , , , , , , ~ ~ ~ ^ ^ A M M A A A A A A M A A A A A A A
, , . , , . . . . . , , , , . , , , , , ~ ~ A M A A A A A A A A A A A A A M M A
, , . . . . . . . , , . , ~ , . , , , ~ ~ ^ A A A A A M A A A A A M A A A A A A